0310213310231333222020020201022200113202
1021130110011010003132033310002023113033
1102212211320021022111333130021112122002
1013113033110102033102313210033001212323
1002020100302011003100100130212001332223
3223123003310101333200123102003330103112
3013323023100013213130333330032323121220
2233022303301032220101331302132100021333
0213103231310223130032321113103223133231
0110120313121010111330102132213033131330
2020020123020103001221223302100021001331
1332221210331132011110303310230013112130
1323030113333303130222002100233302232131
1322321012121110012203101120113012000200
2123023200100133012033123130220013132122
0112201001233101133321223331112122113131
2030231122321120220030223321132022011311
0001120021213000112333011201230211003102
2033231321120331012100133021213211023301
2021030120231012032022223203012020330003
