2012011122011101121001301202012020101013
1322210322120130312230132131322211320302
2013202030321220113112002111032212031322
2120223121130303101122321112121303120132
2033201211203220132031130122012111213022
0301312202130213202210211222222020120312
2030203131203102032122122211311313131203
1303311201220223121132221130111202011312
0301111321313211220302211113013131301303
0212112030112122131132010112120201201222
3031122203012220101113221211122132132132
0200312132121321320102103102222102003012
2221122100211130130322130232031132211132
2320121232203003203032013113030203201203
0131213113201312130211320112203131131302
1122111111312022012302111130322002011232
0311201122021232123032012021321321312122
2011311220311303020321303211211220011322
2201112221301220332110212220113132301132
1131111311131131111113121131111111111113
