0110013130132331200023211211130221303123
1323003113213123310223001310202320301021
3300031120022221131312111313021103232122
3113011013013020133233003011313321110132
0010121120300123013321110033203321121221
3300110132000020030302021011221111031133
2200110220020103113003232302122331332131
3110112332120211032230300022312220311203
3300132033132222113312300001333003010002
3123012203231023210323022303222021002213
3313233113200210221201033311122320002210
3132103123022131013022312100113331313010
2203233103002133120223020303313210131220
2013201003332120103102301203333310000301
2110311111122100232031132111022032011312
0301101301201112200021331102312011011303
0222303220221102122210320131222033000132
1221001312321200301301021332202331212221
0301031001201330301333320023230122232312
0331130300011221100210303102230313130321
